15	15	15	15	15	15	15	15	15	15	15	15	15	15	15	15	15	15	15	15	15	15	28	16	16	17	29
15	15	15	15	15	28	18	17	16	29	15	15	15	15	15	15	15	15	15	15	15	15	24	05	03	02	25
15	15	15	15	15	24	05	02	04	25	15	15	15	15	15	15	15	15	15	15	15	15	24	08	06	06	25
15	15	15	15	15	24	08	06	07	25	15	15	15	15	15	15	28	17	17	18	29	15	26	21	21	21	27
15	15	15	15	15	26	21	21	21	27	15	15	15	15	15	15	24	05	03	04	25	15	15	15	15	15	15
15	15	15	15	15	15	15	15	15	15	15	15	15	15	15	15	24	10	00	09	25	15	15	15	15	15	15
15	15	15	15	15	15	15	15	15	15	15	15	15	15	15	15	24	10	00	09	25	15	15	15	15	15	15
15	15	15	15	15	15	15	15	15	15	15	15	15	15	15	15	24	10	00	09	25	15	15	15	15	15	15
16	17	16	16	18	18	17	16	17	29	28	16	17	18	18	17	19	10	00	09	25	15	15	28	17	18	18
02	03	01	01	03	02	02	01	04	25	24	05	02	03	03	01	01	12	00	09	25	28	16	19	05	03	01
00	00	00	00	00	00	00	00	09	25	24	10	00	00	00	00	00	00	00	09	20	19	05	02	12	00	00
00	00	00	00	00	00	00	00	09	25	24	10	00	00	00	00	00	00	00	11	01	02	12	00	00	00	00
00	00	00	00	00	00	00	00	09	25	24	10	00	00	00	00	00	00	00	00	00	00	00	00	00	00	00
00	13	06	06	06	14	00	00	09	25	24	10	00	00	00	00	00	00	00	00	00	00	00	00	13	06	06
00	09	23	21	22	10	00	00	09	20	19	10	00	00	00	00	00	00	00	00	00	00	00	00	09	23	21
00	09	20	18	19	10	00	00	11	03	02	12	00	00	13	06	06	06	14	00	00	00	00	00	09	25	15
00	11	03	02	01	12	00	00	00	00	00	00	00	00	09	23	21	22	10	00	00	00	00	00	09	20	18
00	00	00	00	00	00	00	00	00	00	00	00	00	00	09	20	17	19	10	00	00	00	00	00	11	01	03
00	00	00	00	00	00	00	00	00	00	00	00	00	00	11	03	02	02	12	00	00	00	00	00	00	00	00
