15 15 15 15 15 15 15 15 15 15 15 15 15 15 15 15 15 15 15 15 15 15 15 15 15 15
15 15 15 15 15 15 15 15 15 15 15 15 15 15 15 15 15 15 15 15 15 15 15 15 15 15
15 15 15 15 15 15 15 15 15 15 15 15 15 15 15 15 15 15 15 15 15 15 15 15 15 15
15 15 15 15 15 15 15 15 15 15 15 15 15 15 15 15 15 15 15 15 15 15 15 15 15 15
15 15 15 15 15 15 15 15 15 15 15 15 15 15 15 15 15 15 15 15 15 15 15 15 15 15
15 15 15 15 15 15 15 15 15 15 15 15 15 15 15 15 15 15 15 15 15 15 15 15 15 15
15 15 15 15 15 15 15 15 15 15 15 15 15 15 15 15 15 15 15 15 15 15 15 15 15 15
16 18 17 18 16 16 17 29 15 15 15 15 15 15 15 15 15 15 15 15 15 15 15 15 15 15
01 02 01 03 02 03 04 20 16 29 15 15 15 15 15 15 15 15 15 15 15 15 15 15 15 15
00 00 00 00 00 00 11 01 04 20 17 17 18 29 15 15 15 15 15 15 15 15 15 15 15 15
00 00 00 00 00 00 00 00 11 02 03 01 04 20 17 16 29 15 15 15 15 15 15 15 15 15
00 00 00 00 00 00 00 00 00 00 00 00 11 02 03 04 20 17 29 15 15 15 15 15 15 15
00 00 00 00 00 00 00 00 00 00 00 00 00 00 00 11 01 04 20 18 17 16 17 17 18 16
00 00 00 00 00 00 00 00 00 00 00 00 00 00 00 00 00 11 01 02 01 03 03 02 01 03
00 00 00 00 00 00 00 00 00 00 00 00 00 00 00 00 00 00 00 00 00 00 00 00 00 00
00 00 00 00 00 00 00 00 00 00 00 00 00 00 00 00 00 00 00 00 00 00 00 00 00 00
00 00 00 00 00 00 00 00 00 00 00 00 00 00 00 00 00 00 00 00 00 00 00 00 00 00