24  18
15	15	15	15	15	15	15	15	15	15	15	15	15	15	15	15	15	15	15	15	15	15	15	15
15	15	15	15	15	15	15	15	15	15	15	15	15	15	15	15	15	15	15	15	15	15	15	15
15	15	15	15	15	15	15	15	15	15	15	15	15	15	15	15	15	15	15	15	15	15	15	15
15	15	15	15	15	15	15	15	15	15	15	15	15	15	15	15	15	15	15	15	15	15	15	15
15	15	15	15	15	15	15	15	15	15	15	15	15	15	15	15	15	15	15	15	15	15	15	15
15	15	15	15	15	15	15	15	15	15	15	15	15	15	15	15	15	15	15	15	15	15	15	15
15	15	15	15	15	15	15	15	15	15	15	15	15	15	15	15	15	15	15	15	15	15	15	15
15	15	15	15	15	15	15	15	15	15	15	15	15	15	15	15	15	15	15	15	15	15	15	15
16	18	16	17	18	18	16	29	15	15	15	15	15	15	15	15	28	16	17	17	18	16	16	17
01	02	01	03	02	03	04	25	15	15	15	15	15	15	15	15	24	05	01	02	03	03	02	01
00	00	00	00	00	00	09	25	15	15	15	15	15	15	15	15	24	10	00	00	00	00	00	00
00	00	00	00	00	00	09	25	15	15	15	15	15	15	15	15	24	10	00	00	00	00	00	00
00	00	00	00	00	00	09	25	15	15	15	15	15	15	15	15	24	10	00	00	00	00	00	00
00	00	00	00	00	00	09	20	16	18	17	18	18	18	17	16	19	10	00	00	00	00	00	00
00	00	00	00	00	00	11	02	01	03	03	02	02	01	03	02	01	12	00	00	00	00	00	00
00	00	00	00	00	00	00	00	00	00	00	00	00	00	00	00	00	00	00	00	00	00	00	00
00	00	00	00	00	00	00	00	00	00	00	00	00	00	00	00	00	00	00	00	00	00	00	00
00	00	00	00	00	00	00	00	00	00	00	00	00	00	00	00	00	00	00	00	00	00	00	00
