29 21
15 15 15 15 15 15 15 15 15 15 15 15 15 15 15 15 15 15 15 15 15 15 15 15 15 15 15 15 15
15 15 15 15 15 15 15 15 15 15 15 15 15 15 15 15 15 15 15 15 15 15 15 15 15 15 15 15 15
15 15 15 15 15 15 15 15 15 15 15 15 15 15 15 15 15 15 15 15 15 15 15 15 15 15 15 15 15
15 15 15 15 15 15 15 15 15 15 15 15 15 15 15 15 15 15 15 15 15 15 15 15 15 15 15 15 15
15 15 15 15 15 15 15 15 15 15 15 15 15 15 15 15 15 15 15 15 15 15 15 15 15 15 15 15 15
15 15 15 15 15 15 15 15 15 28 17 17 18 29 15 28 17 16 17 29 15 15 15 15 15 15 15 15 15
15 15 15 15 15 15 15 15 15 24 05 01 04 25 15 24 05 01 04 25 15 15 15 15 15 15 15 15 15
15 15 15 15 15 15 15 15 15 24 10 00 09 25 15 24 10 00 09 25 15 15 15 15 15 15 15 15 15
16 17 17 18 16 17 17 29 15 24 10 00 09 25 15 24 10 00 09 25 15 28 17 16 17 17 18 17 16
02 03 03 02 02 01 04 25 15 24 10 00 09 25 15 24 10 00 09 25 15 24 05 01 01 01 02 02 01
00 00 00 00 00 00 09 25 15 24 10 00 09 25 15 24 10 00 09 25 15 24 10 00 00 00 00 00 00
00 00 00 00 00 00 09 20 16 19 10 00 09 25 15 24 10 00 09 20 16 19 10 00 00 00 00 00 00
00 00 00 00 00 00 11 01 02 01 12 00 09 25 15 24 10 00 11 01 03 02 12 00 00 00 00 00 00
00 00 00 00 00 00 00 00 00 00 00 00 09 25 15 24 10 00 00 00 00 00 00 00 00 00 00 00 00
00 00 00 00 00 00 00 00 00 00 00 00 09 20 18 19 10 00 00 00 00 00 00 00 00 00 00 00 00
00 00 00 00 00 00 00 00 00 00 00 00 11 01 02 01 12 00 00 00 00 00 00 00 00 00 00 00 00
00 00 00 00 00 00 00 00 00 00 00 00 00 00 00 00 00 00 00 00 00 00 00 00 00 00 00 00 00
00 00 00 00 00 00 00 00 00 00 00 00 00 00 00 00 00 00 00 00 00 00 00 00 00 00 00 00 00
00 00 00 00 00 00 00 00 00 00 00 00 00 00 00 00 00 00 00 00 00 00 00 00 00 00 00 00 00
00 00 00 00 00 00 00 00 00 00 00 00 00 00 00 00 00 00 00 00 00 00 00 00 00 00 00 00 00
00 00 00 00 00 00 00 00 00 00 00 00 00 00 00 00 00 00 00 00 00 00 00 00 00 00 00 00 00