43 24
15 15 15 15 15 15 15 15 15 15 15 15 15 15 15 15 15 15 15 15 15 15 15 15 15 15 15 15 15 15 15 15 15 15 15 15 15 15 15 15 15 15 15
15 15 15 15 15 15 15 15 15 15 15 15 15 15 15 15 15 15 15 15 15 15 15 15 15 15 15 15 15 15 15 15 15 15 15 15 15 15 15 15 15 15 15
15 15 15 15 15 15 15 15 15 15 15 15 15 15 15 15 15 15 15 15 15 15 15 15 15 15 15 15 15 15 15 15 15 15 15 15 15 15 15 15 15 15 15
15 15 15 15 15 15 15 15 15 15 15 15 15 15 15 15 15 15 15 15 15 15 15 15 15 15 15 15 15 15 15 15 15 15 15 15 15 15 15 15 15 15 15
15 15 15 15 15 15 15 15 15 15 15 15 15 15 15 15 15 15 15 15 15 15 15 15 15 15 15 15 15 15 15 15 15 15 15 15 15 15 15 15 15 15 15
15 15 15 15 15 15 15 15 15 15 15 15 15 15 28 16 18 16 17 16 18 17 17 18 16 18 16 16 29 15 15 15 15 15 15 15 15 15 15 15 15 15 15
15 15 15 15 15 15 15 15 15 15 15 15 15 15 24 05 01 02 01 02 01 03 03 01 03 03 03 04 25 15 15 15 15 15 15 15 15 15 15 15 15 15 15
15 15 15 15 15 15 15 15 15 15 15 15 15 15 24 10 00 00 00 00 00 00 00 00 00 00 00 09 25 15 15 15 15 15 15 15 15 15 15 15 15 15 15
15 15 15 15 15 15 15 15 15 15 15 28 18 18 19 10 00 00 00 00 00 00 00 00 00 00 00 09 25 15 15 15 15 15 15 15 15 15 15 15 15 15 15
15 15 15 15 15 15 15 15 15 15 15 24 05 01 01 12 00 00 00 00 00 00 00 00 00 00 00 09 25 15 15 15 15 15 15 15 15 15 15 15 15 15 15
15 15 15 15 15 15 15 15 15 15 15 24 10 00 00 00 00 00 00 00 00 00 00 00 00 00 00 09 25 15 15 15 15 15 15 15 15 15 15 15 15 15 15
15 15 15 15 15 15 15 15 28 16 17 19 10 00 00 00 00 00 00 00 00 00 00 00 00 00 00 09 20 17 17 29 15 15 15 15 15 15 15 15 15 15 15
15 15 15 15 15 15 15 15 24 05 03 01 12 00 00 00 00 00 00 00 00 00 00 00 00 00 00 11 02 02 04 25 15 15 15 15 15 15 15 15 15 15 15
15 15 15 15 15 15 15 15 24 10 00 00 00 00 00 00 00 00 00 00 00 00 00 00 00 00 00 00 00 00 09 25 15 15 15 15 15 15 15 15 15 15 15
15 15 15 15 15 15 15 15 24 10 00 00 00 00 00 00 00 00 00 00 00 00 00 00 00 00 00 00 00 00 09 20 17 16 29 15 15 15 15 15 15 15 15
15 15 15 15 15 15 15 15 24 10 00 00 00 00 00 00 00 00 00 00 00 00 00 00 00 00 00 00 00 00 11 01 01 04 25 15 15 15 15 15 15 15 15
15 15 15 15 15 15 15 15 24 10 00 00 00 00 00 00 00 00 00 00 00 00 00 00 00 00 00 00 00 00 00 00 00 09 25 15 15 15 15 15 15 15 15
18 18 18 16 18 17 17 16 19 10 00 00 00 00 00 00 00 00 00 00 00 00 00 00 00 00 00 00 00 00 00 00 00 09 20 17 18 16 17 17 18 16 16
03 03 01 03 01 02 02 02 02 12 00 00 00 00 00 00 00 00 00 00 00 00 00 00 00 00 00 00 00 00 00 00 00 11 02 02 03 03 01 02 03 02 01
00 00 00 00 00 00 00 00 00 00 00 00 00 00 00 00 00 00 00 00 00 00 00 00 00 00 00 00 00 00 00 00 00 00 00 00 00 00 00 00 00 00 00
00 00 00 00 00 00 00 00 00 00 00 00 00 00 00 00 00 00 00 00 00 00 00 00 00 00 00 00 00 00 00 00 00 00 00 00 00 00 00 00 00 00 00
00 00 00 00 00 00 00 00 00 00 00 00 00 00 00 00 00 00 00 00 00 00 00 00 00 00 00 00 00 00 00 00 00 00 00 00 00 00 00 00 00 00 00
00 00 00 00 00 00 00 00 00 00 00 00 00 00 00 00 00 00 00 00 00 00 00 00 00 00 00 00 00 00 00 00 00 00 00 00 00 00 00 00 00 00 00
00 00 00 00 00 00 00 00 00 00 00 00 00 00 00 00 00 00 00 00 00 00 00 00 00 00 00 00 00 00 00 00 00 00 00 00 00 00 00 00 00 00 00