200 150 100
46 26
15 15 15 15 15 15 15 15 15 15 15 15 15 15 15 15 15 24 10 00 00 09 25 15 15 15 15 15 15 15 15 15 15 15 15 15 15 15 15 15 15 15 15 15 15 15
15 15 15 15 15 15 15 15 15 15 15 15 15 15 15 15 15 24 10 00 00 09 25 15 15 15 15 15 15 15 15 15 15 15 15 15 15 15 15 28 18 16 16 18 18 17
16 16 18 17 18 16 29 15 15 15 15 15 15 15 15 15 15 24 10 00 00 09 25 15 15 15 15 15 15 15 15 15 15 15 15 15 15 15 15 24 05 02 03 01 01 01
01 02 02 02 03 04 25 15 15 15 15 15 15 15 15 15 15 24 10 00 00 09 25 15 15 15 15 15 15 15 15 15 15 15 15 15 15 15 15 24 08 06 06 14 00 00
00 00 00 00 00 09 25 15 15 15 15 15 15 15 15 15 15 24 10 00 00 09 25 15 15 15 15 15 15 28 17 18 18 16 17 18 29 15 15 26 21 21 22 10 00 00
06 06 06 06 06 07 25 15 15 15 15 15 15 15 15 15 15 24 10 00 00 09 25 15 15 15 15 15 15 24 05 03 01 01 03 04 25 15 15 15 15 15 24 10 00 00
21 21 21 21 21 21 27 15 15 15 28 17 18 18 29 15 15 24 08 06 06 07 25 15 15 28 17 17 16 19 10 13 06 06 06 07 25 15 15 15 15 15 24 10 00 00
15 15 15 15 15 15 15 15 15 15 24 05 01 04 25 15 15 26 21 21 21 21 27 15 15 24 05 01 01 03 12 09 23 21 21 21 27 15 15 15 15 15 24 10 00 00
15 15 15 15 15 15 15 15 15 15 24 10 00 09 25 15 15 15 15 15 15 15 15 15 15 24 08 06 06 06 06 07 25 15 15 15 15 15 15 15 15 15 24 10 00 00
15 15 15 15 15 15 15 15 15 15 24 10 00 09 25 15 15 15 15 15 15 15 15 15 15 26 21 21 21 21 21 21 27 15 15 15 15 15 15 15 15 15 24 10 00 00
18 17 16 17 17 29 15 28 18 17 19 10 00 09 20 18 18 18 29 15 15 28 17 16 18 16 16 17 16 16 16 16 17 16 16 29 15 15 15 15 15 15 24 10 00 00
02 01 02 02 04 25 15 24 05 03 03 12 00 11 01 02 03 04 25 15 15 24 05 03 01 02 01 03 01 02 02 03 01 02 04 25 15 15 15 15 15 15 24 10 00 00
00 00 00 00 09 25 15 24 10 00 00 00 00 00 00 00 00 09 25 15 15 24 10 13 06 06 06 06 06 06 06 06 06 14 09 25 15 15 15 15 15 15 24 10 00 00
00 00 00 00 09 25 15 24 10 00 00 00 00 00 00 00 00 09 20 16 29 24 10 09 23 21 21 21 21 21 21 21 22 10 09 25 15 15 15 28 16 18 19 10 00 00
00 00 00 00 09 20 16 19 10 00 00 00 00 00 00 00 00 11 01 04 25 24 10 09 20 18 18 18 16 16 18 18 19 10 09 25 15 15 15 24 05 02 03 12 00 00
00 00 00 00 11 03 03 02 12 00 00 00 00 00 00 00 00 00 00 09 25 24 10 11 03 02 03 02 01 01 02 01 03 12 09 25 15 15 15 24 10 00 00 00 00 00
00 00 00 00 00 00 00 00 00 13 06 06 06 06 06 14 00 00 00 09 20 19 10 00 00 00 00 00 00 00 00 00 00 00 09 20 16 16 17 19 10 00 00 00 00 00
00 00 00 00 00 00 00 00 00 09 23 21 21 21 22 10 00 00 00 11 03 02 12 00 00 13 06 06 06 06 06 14 00 00 11 03 03 02 02 02 12 00 00 00 00 00
00 00 00 00 00 00 00 00 00 09 20 18 16 16 19 10 00 00 00 00 00 00 00 00 00 09 23 21 21 21 22 10 00 00 00 00 00 00 00 00 00 00 00 00 00 00
00 00 00 00 00 00 00 00 00 11 01 01 01 03 03 12 00 00 00 00 00 00 00 00 00 09 25 15 15 15 24 10 00 00 00 00 00 00 00 00 00 00 00 00 00 00
00 00 00 00 00 00 00 00 00 00 00 00 00 00 00 00 00 00 00 00 00 00 00 00 00 09 20 17 16 17 19 10 00 00 00 00 00 00 00 00 00 00 00 00 00 00
00 00 00 00 00 00 00 00 00 00 00 00 00 00 00 00 00 00 00 00 00 00 00 00 00 11 01 02 01 03 02 12 00 00 00 00 00 00 00 00 00 00 00 00 00 00
00 00 00 00 00 00 00 00 00 00 00 00 00 00 00 00 00 00 00 00 00 00 00 00 00 00 00 00 00 00 00 00 00 00 00 00 00 00 00 00 00 00 00 00 00 00
00 00 00 00 00 00 00 00 00 00 00 00 00 00 00 00 00 00 00 00 00 00 00 00 00 00 00 00 00 00 00 00 00 00 00 00 00 00 00 00 00 00 00 00 00 00
00 00 00 00 00 00 00 00 00 00 00 00 00 00 00 00 00 00 00 00 00 00 00 00 00 00 00 00 00 00 00 00 00 00 00 00 00 00 00 00 00 00 00 00 00 00
00 00 00 00 00 00 00 00 00 00 00 00 00 00 00 00 00 00 00 00 00 00 00 00 00 00 00 00 00 00 00 00 00 00 00 00 00 00 00 00 00 00 00 00 00 00
2
1 10
41 1
1 11
41 2
