32 20
15 15 15 15 15 15 15 15 15 15 15 15 15 15 15 15 15 15 15 15 15 15 15 15 15 15 15 15 15 15 15 15
15 15 15 15 15 15 15 15 15 15 15 15 15 15 15 15 15 15 15 15 15 15 15 15 15 15 15 15 15 15 15 15
15 15 28 16 18 17 16 29 15 15 15 15 15 15 15 15 15 15 15 15 15 15 15 15 28 18 18 17 16 29 15 15
15 15 24 05 03 03 04 25 15 15 15 15 15 15 15 15 15 15 15 15 15 15 15 15 24 05 03 01 04 25 15 15
15 15 24 10 00 00 09 25 15 15 15 15 15 15 15 15 15 15 15 15 15 15 15 15 24 10 00 00 09 25 15 15
15 15 24 08 06 06 07 25 15 15 15 15 15 15 15 15 15 15 15 15 15 15 15 15 24 08 06 06 07 25 15 15
15 15 26 21 21 21 21 27 15 15 15 15 15 15 15 15 15 15 15 15 15 15 15 15 26 21 21 21 21 27 15 15
15 15 15 15 15 15 15 15 15 15 15 15 15 15 15 15 15 15 15 15 15 15 15 15 15 15 15 15 15 15 15 15
15 15 15 15 15 15 15 15 15 15 15 15 15 28 16 18 17 18 29 15 15 15 15 15 15 15 15 15 15 15 15 15
15 15 15 15 15 15 15 15 15 15 15 28 17 19 05 01 03 04 20 18 29 15 15 15 15 15 15 15 15 15 15 15
15 15 15 15 15 15 15 15 15 28 17 19 05 02 12 00 00 11 02 04 20 16 29 15 15 15 15 15 15 15 15 15
15 15 15 15 15 15 15 28 17 19 05 02 12 00 00 00 00 00 00 11 02 04 20 18 29 15 15 15 15 15 15 15
15 15 15 15 15 28 16 19 05 01 12 00 00 00 00 00 00 00 00 00 00 11 01 04 20 16 29 15 15 15 15 15
16 17 17 17 17 19 05 02 12 00 00 00 00 00 00 00 00 00 00 00 00 00 00 11 01 04 20 17 18 17 18 16
02 02 02 01 02 02 12 00 00 00 00 00 00 00 00 00 00 00 00 00 00 00 00 00 00 11 02 03 03 01 02 02
00 00 00 00 00 00 00 00 00 00 00 00 00 00 00 00 00 00 00 00 00 00 00 00 00 00 00 00 00 00 00 00
00 00 00 00 00 00 00 00 00 00 00 00 00 00 00 00 00 00 00 00 00 00 00 00 00 00 00 00 00 00 00 00
00 00 00 00 00 00 00 00 00 00 00 00 00 00 00 00 00 00 00 00 00 00 00 00 00 00 00 00 00 00 00 00
00 00 00 00 00 00 00 00 00 00 00 00 00 00 00 00 00 00 00 00 00 00 00 00 00 00 00 00 00 00 00 00
00 00 00 00 00 00 00 00 00 00 00 00 00 00 00 00 00 00 00 00 00 00 00 00 00 00 00 00 00 00 00 00