24 18
15 15 15 15 15 15 15 15 15 15 15 15 15 15 15 15 15 15 15 15 15 15 15 15
15 15 15 15 15 15 15 15 15 15 15 15 15 15 15 15 15 15 15 15 15 15 15 15
15 15 15 15 15 15 15 15 15 15 15 15 15 15 15 15 15 15 15 15 15 15 15 15
15 15 15 15 15 15 15 15 15 15 15 15 15 15 15 15 15 15 15 15 15 15 15 15
15 15 15 15 15 15 15 15 15 15 15 15 15 15 15 15 15 15 15 15 15 15 15 15
15 15 15 15 15 15 15 15 15 15 15 15 15 15 15 15 15 15 15 15 15 15 15 15
15 15 15 15 15 15 15 15 15 15 15 15 15 15 15 15 15 15 15 15 15 15 15 15
15 15 15 15 15 15 15 15 15 15 15 15 15 15 15 15 15 15 15 15 15 15 15 15
17 16 16 16 18 17 16 29 15 15 15 15 15 15 15 15 28 17 16 16 17 18 16 18
01 01 02 02 02 03 04 25 15 15 15 15 15 15 15 15 24 05 02 01 03 03 01 03
00 00 00 00 00 00 09 25 15 15 15 15 15 15 15 15 24 10 00 00 00 00 00 00
00 00 00 00 00 00 09 25 15 15 15 15 15 15 15 15 24 10 00 00 00 00 00 00
00 00 00 00 00 00 09 25 15 15 15 15 15 15 15 15 24 10 00 00 00 00 00 00
00 00 00 00 00 00 09 20 16 18 17 17 18 18 16 18 19 10 00 00 00 00 00 00
00 00 00 00 00 00 11 02 02 02 03 01 03 01 02 03 01 12 00 00 00 00 00 00
00 00 00 00 00 00 00 00 00 00 00 00 00 00 00 00 00 00 00 00 00 00 00 00
00 00 00 00 00 00 00 00 00 00 00 00 00 00 00 00 00 00 00 00 00 00 00 00
00 00 00 00 00 00 00 00 00 00 00 00 00 00 00 00 00 00 00 00 00 00 00 00