26 28
15 15 15 15 15 15 15 15 15 15 15 15 15 15 15 15 15 15 15 15 15 15 15 15 15 15
15 15 15 15 15 15 15 15 15 15 15 15 15 15 15 15 15 15 15 15 15 15 15 15 15 15
15 15 15 15 15 15 15 15 15 15 15 15 15 15 15 15 15 15 15 15 15 15 15 15 15 15
15 15 15 15 15 15 15 15 15 15 15 15 15 15 15 15 15 15 15 15 15 15 15 15 15 15
15 15 15 15 15 15 15 15 15 15 15 15 15 15 15 15 15 15 15 15 15 15 15 15 15 15
15 15 15 15 15 15 15 15 15 15 15 15 15 15 15 15 15 15 15 28 18 18 18 29 15 15
15 15 15 15 15 15 15 15 15 15 15 15 15 15 15 15 15 15 15 24 05 03 04 25 15 15
15 15 15 15 15 15 15 15 15 15 15 15 15 15 15 15 15 15 15 24 08 06 07 25 15 15
15 15 15 15 15 15 15 15 15 15 15 15 28 16 16 16 17 29 15 26 21 21 21 27 15 15
15 15 15 15 15 15 15 15 15 15 15 15 24 05 02 03 04 25 15 15 15 15 15 15 15 15
15 15 15 15 15 15 15 15 15 15 15 15 24 10 00 00 09 25 15 15 15 15 15 15 15 15
18 18 18 18 17 18 17 16 17 18 17 18 19 10 00 00 09 20 17 17 18 18 17 16 18 16
02 02 02 02 02 03 03 02 01 01 03 02 02 12 00 00 11 02 02 03 02 01 01 01 01 01
00 00 00 00 00 00 00 00 00 00 13 06 06 06 06 06 14 00 00 00 00 00 00 00 00 00
00 00 00 00 00 00 00 00 00 00 09 23 21 21 21 22 10 00 00 00 00 00 00 00 00 00
00 00 00 00 00 00 00 00 00 00 09 25 15 15 15 24 10 00 00 00 00 00 00 00 00 00
00 00 00 00 00 00 00 00 00 00 09 20 29 15 28 19 10 00 00 00 00 00 00 00 00 00
00 00 00 00 00 00 00 00 00 00 11 04 25 15 24 05 12 00 00 00 00 00 00 00 00 00
00 00 00 00 00 00 00 00 00 00 00 09 25 15 24 08 06 06 06 06 06 06 06 14 00 00
00 00 00 00 00 00 00 00 00 00 00 09 25 15 26 21 21 21 21 21 21 21 22 10 00 00
00 00 00 00 00 00 00 00 00 00 00 09 20 18 17 16 16 16 18 18 17 18 19 10 00 00
00 00 00 00 00 00 00 00 00 00 00 11 03 01 02 03 03 03 02 02 02 02 01 12 00 00
00 00 00 00 00 00 00 00 00 00 00 00 00 00 00 00 00 00 00 00 00 00 00 00 00 00
00 00 00 00 00 00 00 00 00 00 00 00 00 00 00 00 00 00 00 00 00 00 00 00 00 00
00 00 00 00 00 00 00 00 00 00 00 00 00 00 00 00 00 00 00 00 00 00 00 00 00 00
00 00 00 00 00 00 00 00 00 00 00 00 00 00 00 00 00 00 00 00 00 00 00 00 00 00
00 00 00 00 00 00 00 00 00 00 00 00 00 00 00 00 00 00 00 00 00 00 00 00 00 00
00 00 00 00 00 00 00 00 00 00 00 00 00 00 00 00 00 00 00 00 00 00 00 00 00 00