20 20
15 15 15 15 15 15 15 15 15 15 15 15 15 15 15 15 15 15 15 15
15 15 15 15 15 15 15 15 15 15 15 15 15 15 15 15 15 15 15 15
15 15 15 15 15 15 15 15 15 15 15 15 15 15 15 15 15 15 15 15
15 15 15 15 15 15 15 15 15 15 15 15 15 15 15 15 15 15 15 15
15 15 15 15 15 15 15 15 15 15 15 15 15 15 15 15 15 15 15 15
15 15 15 15 15 15 15 15 15 15 15 15 15 15 15 15 15 15 15 15
15 15 15 15 15 15 15 15 15 15 15 15 15 15 15 15 15 15 15 15
15 15 15 15 15 15 15 15 15 15 15 15 15 15 15 15 15 15 15 15
18 17 18 18 17 17 17 16 17 29 28 16 16 18 16 16 16 17 18 18
03 01 02 02 03 02 03 02 04 25 24 05 01 01 02 02 01 01 02 03
00 00 00 00 00 00 00 00 09 25 24 10 00 00 00 00 00 00 00 00
00 00 00 00 00 00 00 00 09 25 24 10 00 00 00 00 00 00 00 00
00 00 00 00 00 00 00 00 09 25 24 10 00 00 00 00 00 00 00 00
00 00 00 00 00 00 00 00 09 25 24 10 00 00 00 00 00 00 00 00
00 00 00 00 00 00 00 00 09 20 19 10 00 00 00 00 00 00 00 00
00 00 00 00 00 00 00 00 11 02 03 12 00 00 00 00 00 00 00 00
00 00 00 00 00 00 00 00 00 00 00 00 00 00 00 00 00 00 00 00
00 00 00 00 00 00 00 00 00 00 00 00 00 00 00 00 00 00 00 00
00 00 00 00 00 00 00 00 00 00 00 00 00 00 00 00 00 00 00 00
00 00 00 00 00 00 00 00 00 00 00 00 00 00 00 00 00 00 00 00