200 100 100
46 26
15 15 15 15 15 15 15 15 15 15 15 15 15 15 15 15 15 15 15 15 15 15 15 15 15 15 15 15 15 15 15 15 15 15 15 15 15 15 15 15 15 15 15 15 15 15
15 15 15 15 15 15 15 15 15 15 15 15 15 15 15 15 15 15 15 15 15 15 15 15 15 15 15 15 15 15 15 15 15 15 28 18 17 18 17 16 16 18 16 16 29 15
15 15 15 15 15 15 15 15 15 15 15 15 15 15 15 15 15 15 15 15 15 15 15 15 15 15 15 15 15 15 15 15 15 15 24 05 02 01 03 02 03 03 02 04 25 15
15 15 15 15 15 15 15 15 15 15 15 15 15 15 15 15 15 15 15 15 15 15 15 15 15 15 15 15 15 15 15 15 15 15 24 08 06 06 06 06 06 06 14 09 25 15
15 15 15 15 15 15 15 15 15 15 15 15 15 15 15 15 15 15 15 15 15 15 15 28 17 17 29 15 28 16 16 29 15 15 26 21 21 21 21 21 21 22 10 09 25 15
15 15 15 15 15 15 15 15 15 15 15 15 15 15 15 15 15 15 15 15 15 15 15 24 05 04 25 15 24 05 04 25 15 15 15 15 15 15 15 15 15 24 10 09 25 15
15 15 15 15 15 15 15 15 15 15 15 15 15 15 15 15 15 15 15 15 15 15 15 24 08 07 25 15 24 10 09 25 15 15 15 15 15 15 15 15 15 24 10 09 25 15
15 15 15 15 15 15 15 15 15 15 15 15 15 15 28 16 18 16 17 18 29 15 15 26 21 21 27 15 24 10 09 25 15 15 15 15 15 15 15 15 15 24 10 09 25 15
15 15 15 15 15 15 15 15 15 15 15 15 15 15 24 05 01 02 03 04 25 15 15 28 17 17 16 29 24 08 07 25 15 15 15 15 15 15 15 15 15 24 10 09 25 15
15 15 15 15 15 15 15 15 15 15 15 15 15 15 24 10 00 00 00 09 25 15 15 24 05 01 04 25 26 21 21 27 15 15 15 15 15 15 15 15 15 24 10 09 25 15
16 16 18 16 18 29 15 15 15 28 17 17 18 16 19 10 00 00 00 09 20 17 18 19 10 00 09 20 16 17 16 17 29 28 18 16 18 17 16 16 18 19 10 09 20 17
03 03 02 02 04 25 15 15 15 24 05 02 02 01 01 12 00 00 00 11 01 03 01 01 12 00 11 02 02 03 02 04 25 24 05 02 02 02 02 02 02 03 12 11 03 01
00 00 00 00 09 25 15 15 15 24 08 06 06 06 06 06 06 06 06 06 06 06 06 06 06 06 06 06 06 06 06 07 25 24 10 00 00 00 00 00 00 00 00 00 00 00
00 00 00 00 09 25 15 15 15 26 21 21 21 21 21 21 21 21 21 21 21 21 21 21 21 21 21 21 21 21 21 21 27 24 10 00 00 00 00 00 00 00 00 00 00 00
00 00 00 00 09 20 17 17 16 16 16 16 18 29 15 15 28 17 16 16 18 17 17 16 18 16 17 16 29 15 15 28 16 19 10 00 00 00 00 00 00 00 00 00 00 00
00 00 00 00 11 02 01 02 03 02 01 02 04 25 15 15 24 05 01 01 01 01 02 02 02 02 03 04 25 15 15 24 05 02 12 00 00 00 00 00 00 00 00 00 00 00
00 00 00 00 00 00 00 00 00 00 00 00 09 25 15 15 24 10 00 00 00 00 00 00 00 00 00 09 25 15 15 24 10 00 00 00 00 00 00 00 00 00 00 00 00 00
00 00 00 00 00 00 00 00 00 00 00 00 09 20 16 17 19 10 00 13 06 06 06 06 06 14 00 09 20 17 17 19 10 00 00 00 00 00 00 00 00 00 00 00 00 00
00 00 00 00 00 00 00 00 00 00 00 00 11 03 01 03 02 12 00 09 23 21 21 21 22 10 00 11 02 01 02 02 12 00 00 00 00 00 00 00 00 00 00 00 00 00
00 00 00 00 00 00 00 00 00 00 00 00 00 00 00 00 00 00 00 09 25 15 15 15 24 10 00 00 00 00 00 00 00 00 00 00 00 00 00 00 00 00 00 00 00 00
00 00 00 00 00 00 00 00 00 00 00 00 00 00 00 00 00 00 00 09 20 16 18 17 19 10 00 13 06 06 06 06 06 06 06 06 06 06 06 06 14 00 00 00 00 00
00 00 00 00 00 00 00 00 00 00 00 00 00 00 00 00 00 00 00 11 01 02 02 01 01 12 00 09 23 21 21 21 21 21 21 21 21 21 21 22 10 00 00 00 00 00
00 00 00 00 00 00 00 00 00 00 00 00 00 00 00 00 00 00 00 00 00 00 00 00 00 00 00 09 20 18 17 16 17 17 16 18 18 18 16 19 10 00 00 00 00 00
00 00 00 00 00 00 00 00 00 00 00 00 00 00 00 00 00 00 00 00 00 00 00 00 00 00 00 11 02 02 01 01 03 01 03 01 02 01 01 03 12 00 00 00 00 00
00 00 00 00 00 00 00 00 00 00 00 00 00 00 00 00 00 00 00 00 00 00 00 00 00 00 00 00 00 00 00 00 00 00 00 00 00 00 00 00 00 00 00 00 00 00
00 00 00 00 00 00 00 00 00 00 00 00 00 00 00 00 00 00 00 00 00 00 00 00 00 00 00 00 00 00 00 00 00 00 00 00 00 00 00 00 00 00 00 00 00 00
2
1 10
38 1
1 11
38 2
