15 15 15 15 15 15 15 15 15 15 15 15 15 15 15 15 15 15 15 15 15 15 15 15 15 15 15
15 15 15 15 15 15 15 15 15 15 15 15 15 15 15 15 15 15 15 15 15 15 15 15 15 15 15
15 15 15 15 15 15 15 15 15 15 15 15 15 15 15 15 15 15 15 15 15 15 15 15 15 15 15
15 15 15 15 15 15 15 15 15 15 15 15 15 15 15 15 15 15 15 15 15 15 15 15 15 15 15
15 15 15 15 15 15 15 15 15 15 15 15 15 15 15 15 15 15 15 15 15 15 15 15 15 15 15
15 15 15 15 15 15 15 15 15 15 15 15 15 15 15 28 16 17 18 29 15 15 15 15 15 15 15
15 15 15 15 15 15 15 15 15 15 15 15 15 15 15 24 05 03 04 25 15 15 15 15 15 15 15
15 15 15 15 15 15 15 15 15 15 15 15 15 15 15 24 10 00 09 25 15 15 15 15 15 15 15
15 15 15 15 15 15 15 28 18 18 17 29 15 15 15 24 10 00 09 25 15 15 15 15 15 15 15
15 15 15 15 15 15 15 24 05 01 04 25 15 15 15 24 10 00 09 25 15 15 15 15 15 15 15
15 15 15 15 15 15 15 24 10 00 09 25 15 15 15 24 10 00 09 25 15 15 15 15 15 15 15
16 16 17 16 18 17 17 19 10 00 09 20 18 17 16 19 10 00 09 20 16 18 17 17 16 18 17
02 02 01 03 02 03 01 02 12 00 11 01 02 01 03 02 12 00 11 03 02 02 03 01 02 03 01
00 00 00 00 00 00 00 00 00 00 00 00 00 00 00 00 00 00 00 00 00 00 00 00 00 00 00
00 00 00 00 00 00 00 00 00 00 00 00 00 00 00 00 00 00 00 00 00 00 00 00 00 00 00
00 00 00 00 00 00 00 00 00 00 00 00 00 00 00 00 00 00 00 00 00 00 00 00 00 00 00
00 00 00 00 00 00 00 00 00 00 00 00 00 00 00 00 00 00 00 00 00 00 00 00 00 00 00
00 00 00 00 00 00 00 00 00 00 00 00 00 00 00 00 00 00 00 00 00 00 00 00 00 00 00