32 30
15 15 15 15 15 15 15 15 15 15 15 15 15 15 15 15 15 15 15 15 15 15 15 15 15 15 15 15 15 15 15 15
15 15 15 15 15 15 15 15 15 15 15 15 15 15 15 15 15 15 15 15 15 15 15 15 15 15 15 15 15 15 15 15
15 15 15 15 15 15 15 15 15 15 15 15 15 15 15 15 15 15 15 15 15 15 15 15 15 15 15 15 15 15 15 15
15 15 15 15 15 15 15 15 15 15 15 15 15 15 15 15 15 15 15 15 15 15 15 15 15 15 15 15 15 15 15 15
15 15 15 15 15 15 15 15 15 15 15 15 15 15 15 15 15 15 15 15 15 15 15 15 15 15 15 15 15 15 15 15
15 15 15 15 15 15 15 15 15 28 17 16 17 29 15 15 15 15 15 15 15 15 15 15 15 15 15 15 15 15 15 15
15 15 15 15 15 15 15 15 15 24 05 01 04 25 15 15 15 15 15 15 15 15 15 15 15 15 15 15 15 15 15 15
15 15 15 15 15 15 15 15 15 24 10 00 09 25 15 15 15 15 15 15 15 15 15 15 15 15 15 15 15 15 15 15
15 15 15 15 15 15 28 18 16 19 10 00 09 25 15 15 15 15 15 15 15 15 15 15 15 15 15 15 15 15 15 15
15 15 15 15 15 15 24 05 03 02 12 00 09 25 15 15 15 15 15 15 15 15 15 15 15 15 15 15 15 15 15 15
15 15 15 15 15 15 24 10 00 00 00 00 09 25 15 15 15 15 15 15 15 15 15 15 15 15 15 15 15 15 15 15
17 18 16 16 16 16 19 10 00 00 00 00 09 20 17 18 29 15 15 15 15 15 15 15 15 15 15 15 15 15 15 15
01 02 02 03 01 03 02 12 00 00 00 00 11 02 01 04 25 15 15 15 15 15 15 15 15 15 15 15 15 15 15 15
00 00 00 00 00 00 00 00 00 00 00 00 00 00 00 09 25 15 15 15 15 15 15 15 15 15 15 15 15 15 15 15
00 00 00 00 00 00 00 00 00 00 00 00 00 00 00 09 25 15 15 15 15 15 15 15 28 18 17 17 16 16 16 18
00 00 00 00 00 00 00 00 00 00 00 00 00 00 00 09 25 15 15 15 15 15 15 15 24 05 02 02 03 02 03 01
00 00 00 00 00 00 00 00 00 00 00 00 00 00 00 09 25 15 15 15 15 15 15 15 24 10 00 00 00 00 00 00
00 00 00 00 00 00 00 00 00 00 00 00 00 00 00 09 20 16 16 29 15 15 15 15 24 10 00 00 00 00 00 00
00 00 00 00 00 00 00 00 00 00 00 00 00 00 00 11 03 02 04 25 15 15 15 15 24 10 00 00 00 00 00 00
00 00 00 00 00 00 00 00 00 00 00 00 00 00 00 00 00 00 09 25 15 15 15 15 24 10 00 00 00 00 00 00
00 00 00 00 00 00 00 00 00 00 00 00 00 00 00 00 00 00 09 25 15 28 16 18 19 10 00 00 00 00 00 00
00 00 00 00 00 00 00 00 00 00 00 00 00 00 00 00 00 00 09 25 15 24 05 03 03 12 00 00 00 00 00 00
00 00 00 00 00 00 00 00 00 00 00 00 00 00 00 00 00 00 09 25 15 24 10 00 00 00 00 00 00 00 00 00
00 00 00 00 00 00 00 00 00 00 00 00 00 00 00 00 00 00 09 20 17 19 10 00 00 00 00 00 00 00 00 00
00 00 00 00 00 00 00 00 00 00 00 00 00 00 00 00 00 00 11 01 01 02 12 00 00 00 00 00 00 00 00 00
00 00 00 00 00 00 00 00 00 00 00 00 00 00 00 00 00 00 00 00 00 00 00 00 00 00 00 00 00 00 00 00
00 00 00 00 00 00 00 00 00 00 00 00 00 00 00 00 00 00 00 00 00 00 00 00 00 00 00 00 00 00 00 00
00 00 00 00 00 00 00 00 00 00 00 00 00 00 00 00 00 00 00 00 00 00 00 00 00 00 00 00 00 00 00 00
00 00 00 00 00 00 00 00 00 00 00 00 00 00 00 00 00 00 00 00 00 00 00 00 00 00 00 00 00 00 00 00
00 00 00 00 00 00 00 00 00 00 00 00 00 00 00 00 00 00 00 00 00 00 00 00 00 00 00 00 00 00 00 00